M, M, M, M, M, M, M, M, M, M, M, M
M, S, C, C, C, C, C, R, C, M, C, M
M, R, C, C, C, C, R, M, C, C, C, M
M, C, C, C, M, C, C, C, C, C, C, M
M, M, R, C, C, M, C, C, C, C, C, M
M, C, C, M, C, C, C, C, C, R, C, M
M, M, R, C, C, C, C, M, C, C, C, M
M, M, R, C, C, R, C, C, M, C, C, M
M, C, C, C, C, C, C, R, C, M, C, M
M, C, C, R, C, C, C, C, R, C, M, M
M, C, C, R, C, C, C, C, C, C, G, M
M, M, M, M, M, M, M, M, M, M, M, M