X, X, X, X, X, X, X, X, X, X
X, S, C, C, C, C, C, G, C, X
X, C, M, M, M, M, C, M, C, X
X, C, M, M, C, C, C, M, C, X
X, C, M, C, C, M, C, C, C, X
X, C, M, C, M, M, C, M, M, X
X, C, C, C, C, C, C, M, M, X
X, M, M, M, M, M, C, M, M, X
X, B, C, C, C, C, C, C, C, X
X, X, X, X, X, X, X, X, X, X
