X, X, X, X, X, X, X, X, X, X
X, B, M, C, C, C, M, B, C, X
X, C, M, M, C, C, M, C, C, X
X, C, M, C, M, C, M, M, C, X
X, C, M, C, C, C, C, M, C, X
X, C, M, M, C, M, M, M, C, X
X, C, C, C, C, C, C, C, C, X
X, S, M, M, C, C, M, M, G, X
X, X, X, X, X, X, X, X, X, X
